1111111111111
1001000101001
1PC0011111001
1P0011E000001
1111111111111


