11111
1PEC1
11101
101C1
10111
11111