11111111111111111111111
11011110111111111111111
1100CEP0111111111111111
11111110111111111111111
11111110111111111111111
11000000000000000011111
11011110111111111111111
11011110111111111111111
11011110111111111111111
11011110000000000000111
11111110111111111111111
11111110111111111111111
11111110111111111111111
11000000000000000011111
11011110111111111111111
11011110111111111111111
11011110111111111111111
11011110000000000000111
11111110111111111111111
11111110111111111111111
11111110111111111111111
11000000000000000011111
11011110111111111111111
11011110111111111111111
11011110111111111111111
11011110000000000000111
11111111111111111111111
11000000000000000011111
11011110111111111111111
11011110111111111111111
11011110111111111111111
11011110000000000000111
11111111111111111111111
11111110111111111111111
11111110111111111111111
11000000000000000011111
11011110111111111111111
11011110111111111111111
11011110111111111111111
11011110000000000000111
11111111111111111111111
11000000000000000011111
11011110111111111111111
11011110111111111111111
11011110111111111111111
11011110000000000000111
11111111111111111111111
11111110111111111111111
11111110111111111111111
11000000000000000011111
11011110111111111111111
11011110111111111111111
11011110111111111111111
11011110000000000000111
11111111111111111111111
11000000000000000011111
11011110111111111111111
11011110111111111111111
11011110111111111111111
11011110000000000000111
11111111111111111111111
11111110111111111111111
11111110111111111111111
11000000000000000011111
11011110111111111111111
11011110111111111111111
11011110111111111111111
11011110000000000000111
11111111111111111111111
11000000000000000011111
11011110111111111111111
11011110111111111111111
11011110111111111111111
11011110000000000000111
11111111111111111111111
11111110111111111111111
11111110111111111111111
11000000000000000011111
11011110111111111111111
11011110111111111111111
11011110111111111111111
11011110000000000000111
11111111111111111111111
11000000000000000011111
11011110111111111111111
11011110111111111111111
11011110111111111111111
11011110000000000000111
11111111111111111111111
11111110111111111111111
11111110111111111111111
11000000000000000011111
11011110111111111111111
11011110111111111111111
11011110111111111111111
11011110000000000000111
11111111111111111111111
11000000000000000011111
11011110111111111111111
11011110111111111111111
11011110111111111111111
11011110000000000000111
11111111111111111111111
11111110111111111111111
11111110111111111111111
11000000000000000011111
11011110111111111111111
11011110111111111111111
11011110111111111111111
11011110000000000000111
11111111111111111111111
11000000000000000011111
11011110111111111111111
11011110111111111111111
11011110111111111111111
11011110000000000000111
11111111111111111111111
11111110111111111111111
11111110111111111111111
11000000000000000011111
11011110111111111111111
11011110111111111111111
11011110111111111111111
11011110000000000000111
11111111111111111111111
11000000000000000011111
11011110111111111111111
11011110111111111111111
11011110111111111111111
11011110000000000000111
11111111111111111111111
11111110111111111111111
11111110111111111111111
11000000000000000011111
11011110111111111111111
11011110111111111111111
11011110111111111111111
11011110000000000000111
11111111111111111111111
11000000000000000011111
11011110111111111111111
11011110111111111111111
11011110111111111111111
11011110000000000000111
11111111111111111111111
11111110111111111111111
11111110111111111111111
11000000000000000011111
11011110111111111111111
11011110111111111111111
11011110111111111111111
11011110000000000000111
11111111111111111111111
11000000000000000011111
11011110111111111111111
11011110111111111111111
11011110111111111111111
11011110000000000000111
11111111111111111111111
11111110111111111111111
11111110111111111111111
11000000000000000011111
11011110111111111111111
11011110111111111111111
11011110111111111111111
11011110000000000000111
11111111111111111111111
11000000000000000011111
11011110111111111111111
11011110111111111111111
11011110111111111111111
11011110000000000000111
11111111111111111111111
11111110111111111111111
11111110111111111111111
11000000000000000011111
11011110111111111111111
11011110111111111111111
11011110111111111111111
11011110000000000000111
11111111111111111111111
11000000000000000011111
11011110111111111111111
11011110111111111111111
11011110111111111111111
11011110000000000000111
11111111111111111111111
11111110111111111111111
11111110111111111111111
11000000000000000011111
11011110111111111111111
11011110111111111111111
11011110111111111111111
11011110000000000000111
11111111111111111111111
11000000000000000011111
11011110111111111111111
11011110111111111111111
11011110111111111111111
11011110000000000000111
11111111111111111111111
11111110111111111111111
11111110111111111111111
11000000000000000011111
11011110111111111111111
11011110111111111111111
11011110111111111111111
11011110000000000000111
11111111111111111111111
11000000000000000011111
11011110111111111111111
11011110111111111111111
11011110111111111111111
11011110000000000000111
11111111111111111111111
11111110111111111111111
11111110111111111111111
11000000000000000011111
11011110111111111111111
11011110111111111111111
11011110111111111111111
11011110000000000000111
11111111111111111111111
11000000000000000011111
11011110111111111111111
11011110111111111111111
11011110111111111111111
11011110000000000000111
11111111111111111111111
11111110111111111111111
11111110111111111111111
11000000000000000011111
11011110111111111111111
11011110111111111111111
11011110111111111111111
11011110000000000000111
11111111111111111111111
11000000000000000011111
11011110111111111111111
11011110111111111111111
11011110111111111111111
11011110000000000000111
11111111111111111111111
11111110111111111111111
11111110111111111111111
11000000000000000011111
11011110111111111111111
11011110111111111111111
11011110111111111111111
11011110000000000000111
11111111111111111111111
11000000000000000011111
11011110111111111111111
11011110111111111111111
11011110111111111111111
11011110000000000000111
11111111111111111111111
11111110111111111111111
11111110111111111111111
11000000000000000011111
11011110111111111111111
11011110111111111111111
11011110111111111111111
11011110000000000000111
11111111111111111111111
11000000000000000011111
11011110111111111111111
11011110111111111111111
11011110111111111111111
11011110000000000000111
11111111111111111111111
11111110111111111111111
11111110111111111111111
11000000000000000011111
11011110111111111111111
11011110111111111111111
11011110111111111111111
11011110000000000000111
11111111111111111111111
11000000000000000011111
11011110111111111111111
11011110111111111111111
11011110111111111111111
11011110000000000000111
11111111111111111111111
11111110111111111111111
11111110111111111111111
11000000000000000011111
11011110111111111111111
11011110111111111111111
11011110111111111111111
11011110000000000000111
11111111111111111111111
11000000000000000011111
11011110111111111111111
11011110111111111111111
11011110111111111111111
11011110000000000000111
11111111111111111111111
11111110111111111111111
11111110111111111111111
11000000000000000011111
11011110111111111111111
11011110111111111111111
11011110111111111111111
11011110000000000000111
11111111111111111111111
11000000000000000011111
11011110111111111111111
11011110111111111111111
11011110111111111111111
11011110000000000000111
11111111111111111111111
11111110111111111111111
11111110111111111111111
11000000000000000011111
11011110111111111111111
11011110111111111111111
11011110111111111111111
11011110000000000000111
11111111111111111111111
11000000000000000011111
11011110111111111111111
11011110111111111111111
11011110111111111111111
11011110000000000000111
11111111111111111111111
11111110111111111111111
11111110111111111111111
11000000000000000011111
11011110111111111111111
11011110111111111111111
11011110111111111111111
11011110000000000000111
11111111111111111111111
11000000000000000011111
11011110111111111111111
11011110111111111111111
11011110111111111111111
11011110000000000000111
11111111111111111111111
11111110111111111111111
11111110111111111111111
11000000000000000011111
11011110111111111111111
11011110111111111111111
11011110111111111111111
11011110000000000000111
11111111111111111111111
11000000000000000011111
11011110111111111111111
11011110111111111111111
11011110111111111111111
11011110000000000000111
11111111111111111111111
11111110111111111111111
11111110111111111111111
11000000000000000011111
11011110111111111111111
11011110111111111111111
11011110111111111111111
11011110000000000000111
11111111111111111111111
11000000000000000011111
11011110111111111111111
11011110111111111111111
11011110111111111111111
11011110000000000000111
11111111111111111111111
11111110111111111111111
11111110111111111111111
11000000000000000011111
11011110111111111111111
11011110111111111111111
11011110111111111111111
11011110000000000000111
11111111111111111111111
11000000000000000011111
11011110111111111111111
11011110111111111111111
11011110111111111111111
11011110000000000000111
11111111111111111111111
11111110111111111111111
11111110111111111111111
11000000000000000011111
11011110111111111111111
11011110111111111111111
11011110111111111111111
11011110000000000000111
11111111111111111111111
11000000000000000011111
11011110111111111111111
11011110111111111111111
11011110111111111111111
11011110000000000000111
11111111111111111111111
11111110111111111111111
11111110111111111111111
11000000000000000011111
11011110111111111111111
11011110111111111111111
11011110111111111111111
11011110000000000000111
11111111111111111111111
11000000000000000011111
11011110111111111111111
11011110111111111111111
11011110111111111111111
11011110000000000000111
11111111111111111111111
11111110111111111111111
11111110111111111111111
11000000000000000011111
11011110111111111111111
11011110111111111111111
11011110111111111111111
11011110000000000000111
11111111111111111111111
11000000000000000011111
11011110111111111111111
11011110111111111111111
11011110111111111111111
11011110000000000000111
11111111111111111111111
11111110111111111111111
11111110111111111111111
11000000000000000011111
11011110111111111111111
11011110111111111111111
11011110111111111111111
11011110000000000000111
11111111111111111111111
11000000000000000011111
11011110111111111111111
11011110111111111111111
11011110111111111111111
11011110000000000000111
11111111111111111111111
11111110111111111111111
11111110111111111111111
11000000000000000011111
11011110111111111111111
11011110111111111111111
11011110111111111111111
11011110000000000000111
11111111111111111111111
11000000000000000011111
11011110111111111111111
11011110111111111111111
11011110111111111111111
11011110000000000000111
11111111111111111111111
11111110111111111111111
11111110111111111111111
11000000000000000011111
11011110111111111111111
11011110111111111111111
11011110111111111111111
11011110000000000000111
11111111111111111111111
11000000000000000011111
11011110111111111111111
11011110111111111111111
11011110111111111111111
11011110000000000000111
11111111111111111111111
11111110111111111111111
11111110111111111111111
11000000000000000011111
11011110111111111111111
11011110111111111111111
11011110111111111111111
11011110000000000000111
11111111111111111111111
11000000000000000011111
11011110111111111111111
11011110111111111111111
11011110111111111111111
11011110000000000000111
11111111111111111111111
11111110111111111111111
11111110111111111111111
11000000000000000011111
11011110111111111111111
11011110111111111111111
11011110111111111111111
11011110000000000000111
11111111111111111111111
11000000000000000011111
11011110111111111111111
11011110111111111111111
11011110111111111111111
11011110000000000000111
11111111111111111111111
11111110111111111111111
11111110111111111111111
11000000000000000011111
11011110111111111111111
11011110111111111111111
11011110111111111111111
11011110000000000000111
11111111111111111111111
11000000000000000011111
11011110111111111111111
11011110111111111111111
11011110111111111111111
11011110000000000000111
11111111111111111111111
11111110111111111111111
11111111111111111111111
